                                                                                                         
                           +------+                     +--------+                                       
                           |......|                     |........|                                       
                     +-----+......+-----+               |........|                                       
                     |..................|       +-------+........+-------+                               
                     |.....+------+.....|       |........................|                               
                     |.....|      |.....#########.......+--------+.......|                               
                     |.....|      |.....|       |.......|        |.......############                    
                     |.....+------+.....|       |.......+--------+.......|          #          +--+      
                     |..................|       |........................|          #          |..|      
                     +-----+......+-----+       +-------+.........+------+          #       +--+..+--+   
                           |......|                     |.........|                 #       |........|   
                           +---#--+                     |.........|                 #       |..+--+..+-+ 
                               #                        +----#----+                 #########..|  |....| 
                               #                             #                      #       |..+--+..+-+ 
           +------+            #                             #                      #       |........|   
           |......|            #               ######        #                      #       +--+...+-+   
     +-----+......+-----+      #              ##    ##       #      +------+        #          |...|     
     |..................|      #              #      #       #      |......|        #          +---+     
     |.....+------+.....|      #              #      #       ########......##########                    
     |.....|      |.....######################################      |......|                             
     |.....|      |.....|         #    #                            +------+                             
     |.....+------+.....|         #    #                                                                 
     |..................|         #    #                                                                 
     +-----+......+-----+          ####                                                                  
           |......|                                                                                      
           +------+                                                                                       